------P-
SSSSLSSS
-F--L---
SSLSSSLS
--L-M-L-
SSSSSSSS