XXXXXXXXXXXX
X-------P--X
XSSSSSLSSSSX
X-----L----X
X-F---L-F--X
XSSSLSSSLSSX
X---L---L--X
X-F-L---L--X
XSSLSS-SSLSX
X--L-----L-X
X--L--M--L-X
XSSSSSSSSSSX