XXXXXXXXXX
X------P-X
XSSSSLSSSX
X----L---X
XF---L-F-X
XSSLSSSLSX
X--L---L-X
XF-L---L-X
XSLSS-SSLX
X-L-----LX
X-L--M--LX
XSSSSSSSSX